31 31 31 31 31 31 31 31 31 31 31 31 31 31 31 31 31 31 31 31 31 31 31 31 31 31 31 31 31 31 31 31 31 31 31 31 31 31 31 31 31 31 31 31 31 31 31 31 31 31 
31 31 31 31 31 31 31 31 31 31 31 31 31 31 31 31 31 31 31 31 31 31 31 31 31 31 31 31 31 31 31 31 31 31 31 31 31 31 31 31 31 31 31 31 31 31 31 31 31 31 
31 31 31 31 31 31 31 31 31 31 31 31 31 31 31 31 31 31 31 31 31 31 31 31 31 31 31 31 31 31 31 31 31 31 31 31 31 31 31 31 31 31 31 31 31 31 31 31 31 31 
31 31 31 31 31 31 31 31 31 31 31 31 31 31 31 31 31 31 31 31 31 31 31 31 31 31 31 31 31 31 31 31 31 31 31 31 31 31 31 31 31 31 31 31 31 31 31 31 31 31 
31 31 31 31 31 31 31 31 31 31 31 31 31 31 31 31 31 31 31 31 31 31 31 31 31 31 31 31 31 31 31 31 31 31 31 31 31 31 31 31 31 31 31 31 31 31 31 31 31 31 
31 31 31 31 31 31 31 31 31 31 31 31 31 31 31 31 31 31 31 31 31 31 31 31 31 31 31 31 31 31 31 31 31 31 31 31 31 31 31 31 31 31 31 31 31 31 31 31 31 31 
31 31 31 31 31 31 31 31 31 31 31 31 31 31 31 31 31 31 31 31 31 31 31 31 31 31 31 31 31 31 31 31 31 31 31 31 31 31 31 31 31 31 31 31 31 31 31 31 31 31 
31 31 31 31 31 31 31 31 31 31 31 31 31 31 31 31 31 31 31 31 31 31 31 31 31 31 31 31 31 31 31 31 31 31 31 31 31 31 31 31 30 31 31 31 31 31 31 31 31 31 
31 31 31 31 31 31 31 31 31 31 31 31 31 31 31 31 31 31 31 31 31 31 31 31 31 31 31 31 31 31 31 31 31 31 31 31 31 31 31 31 31 31 31 31 31 31 31 31 31 31 
31 31 31 31 31 31 31 31 31 31 31 31 32 33 33 33 33 33 33 33 33 33 33 33 33 33 33 33 33 33 33 33 33 33 33 33 30 31 31 31 31 31 31 31 31 31 31 31 31 31 
31 31 31 31 31 31 31 31 31 31 31 31 32 51 52 52 52 52 52 52 52 53 0 0 0 0 0 0 0 54 0 54 54 54 54 54 30 31 31 31 31 31 31 31 31 31 31 31 31 31 
31 31 31 31 31 31 31 31 31 31 31 31 32 48 49 49 49 49 49 49 49 50 0 0 0 0 0 0 0 0 0 0 0 0 54 0 30 31 31 31 31 31 31 31 31 31 31 31 31 31 
31 31 31 31 31 31 31 31 31 31 31 31 32 48 49 49 49 49 49 49 56 47 0 0 0 0 0 0 0 0 0 0 0 0 0 0 30 31 31 31 31 31 31 31 31 31 31 31 31 31 
31 31 31 31 31 31 31 31 31 31 31 31 32 48 49 49 49 49 49 49 50 0 0 0 0 0 39 41 42 41 42 37 37 37 37 36 30 31 31 31 31 31 31 31 31 31 31 31 31 31 
31 31 31 31 31 31 31 31 31 31 31 31 32 45 46 46 46 46 46 46 47 0 0 0 0 0 40 43 44 43 44 59 54 54 54 0 30 31 31 31 31 31 31 31 31 31 31 31 31 31 
31 31 31 31 31 31 31 31 31 31 31 31 32 0 0 0 0 0 54 0 54 54 0 0 0 0 40 0 0 0 0 0 0 54 0 0 30 31 31 31 31 31 31 31 31 31 31 31 31 31 
31 31 31 31 31 31 31 31 31 31 31 31 32 39 0 0 0 0 0 54 0 4 0 0 0 0 40 0 0 0 0 0 0 0 0 0 30 31 31 31 31 31 31 31 31 31 31 31 31 31 
31 31 31 31 31 31 31 31 31 31 31 31 32 40 0 0 0 0 3 0 0 5 0 0 0 0 40 59 59 0 0 0 0 0 0 0 30 31 31 39 31 31 31 31 31 31 31 31 31 31 
31 31 31 31 31 31 31 31 31 31 31 31 32 40 3 0 0 0 0 0 0 5 0 0 0 0 36 0 0 0 0 0 0 59 59 59 30 41 42 40 30 31 31 31 31 31 31 31 31 31 
31 31 31 31 31 31 31 31 31 31 31 31 32 40 0 0 0 3 0 0 3 5 0 0 0 0 0 0 0 0 0 0 0 0 0 2 30 43 44 40 30 31 31 31 31 31 31 31 31 31 
31 31 31 31 31 31 31 31 31 31 31 31 32 40 0 0 0 3 0 0 3 5 0 0 0 0 0 0 0 0 0 0 0 0 2 2 30 31 31 40 30 31 31 31 31 31 31 31 31 31 
31 31 31 31 31 31 31 31 31 31 31 31 32 40 0 0 0 0 0 3 3 5 0 0 0 0 0 0 0 0 0 27 27 27 27 27 30 31 31 40 30 31 31 31 31 31 31 31 31 31 
31 31 31 31 31 31 31 31 31 31 31 31 32 36 0 11 9 9 9 9 9 9 9 9 9 9 9 9 12 0 54 33 33 35 35 35 30 31 31 40 30 31 31 31 31 31 31 31 31 31 
31 31 31 31 31 31 31 31 31 31 31 31 32 27 27 27 27 27 27 27 27 27 27 29 0 0 0 27 27 38 37 37 37 37 37 37 30 39 37 36 30 31 31 31 31 31 31 31 31 31 
31 31 31 31 31 31 31 31 31 31 31 31 32 30 31 31 31 31 31 31 31 31 31 32 0 0 0 31 31 29 0 3 3 2 0 0 30 28 28 28 31 31 31 31 31 31 31 31 31 31 
31 31 31 31 31 31 31 31 31 31 31 31 32 30 31 31 31 31 31 31 31 31 31 32 0 0 0 31 31 32 0 0 0 0 0 0 30 31 31 31 31 31 31 31 31 31 31 31 31 31 
31 31 31 31 31 31 31 31 31 31 31 31 32 31 31 31 31 31 31 31 31 31 31 32 0 0 54 33 33 34 0 0 0 0 0 0 30 31 31 31 30 31 31 31 31 31 31 31 31 31 
31 31 31 31 31 31 31 31 31 31 31 31 32 31 31 31 31 31 31 31 31 31 31 32 0 0 0 0 4 0 0 0 0 0 0 0 30 31 31 31 31 31 31 31 31 31 31 31 31 31 
31 31 31 31 31 31 31 31 31 31 31 31 32 33 33 33 33 33 33 33 33 33 33 34 0 0 0 0 5 0 0 0 0 0 0 0 30 31 31 31 31 31 31 31 31 31 31 31 31 31 
31 31 31 31 31 31 31 31 31 31 31 31 32 1 1 1 54 1 0 0 0 0 0 0 0 0 0 0 5 0 0 0 0 0 0 0 30 31 31 31 30 31 31 31 31 31 31 31 31 31 
31 31 31 31 31 31 31 31 31 31 31 31 32 1 54 1 1 1 0 0 0 0 0 0 0 0 0 2 5 0 0 2 0 0 0 0 30 31 31 31 30 31 31 31 31 31 31 31 31 31 
31 31 31 31 31 31 31 31 31 31 31 31 32 18 25 25 25 25 25 25 24 0 0 0 0 0 0 0 5 0 0 0 0 0 59 0 30 31 31 31 30 31 31 31 31 31 31 31 31 31 
31 31 31 31 31 31 31 31 31 31 31 31 32 19 0 54 0 0 0 2 23 0 3 0 0 0 0 0 5 0 0 0 0 0 0 0 30 31 31 31 30 31 31 31 31 31 31 31 31 31 
31 31 31 31 31 31 31 31 31 31 31 31 32 19 0 0 0 0 0 54 23 0 0 0 0 0 0 0 5 0 0 0 0 0 0 0 30 31 31 31 30 31 31 31 31 31 31 31 31 31 
31 31 31 31 31 31 31 31 31 31 31 31 32 19 0 0 54 0 0 1 23 0 0 0 0 2 0 0 5 0 0 0 0 0 0 3 30 31 31 31 30 31 31 31 31 31 31 31 31 31 
31 31 31 31 31 31 31 31 31 31 31 31 32 19 1 1 1 1 1 1 23 0 0 0 0 0 0 0 5 0 0 0 0 1 1 3 30 31 31 31 30 31 31 31 31 31 31 31 31 31 
31 31 31 31 31 31 31 31 31 31 31 31 32 20 21 26 21 21 21 21 22 0 3 0 0 0 0 0 5 0 0 0 1 1 54 3 30 31 31 59 30 31 31 31 31 31 31 31 31 31 
31 30 30 30 30 30 30 30 30 30 30 30 32 1 1 8 9 9 9 9 9 9 9 9 9 9 9 9 10 0 0 0 54 1 54 3 30 31 31 31 30 31 31 31 31 31 31 31 31 31 
31 30 30 30 30 30 30 30 30 30 30 30 30 28 27 29 28 28 28 28 28 28 28 28 28 28 28 28 28 28 28 28 28 28 28 28 30 31 31 31 30 31 31 31 31 31 31 31 31 31 
31 30 30 30 30 30 30 30 30 30 30 30 30 31 31 32 33 33 33 33 33 33 33 33 33 33 30 31 31 31 31 31 31 31 31 31 31 31 31 31 30 31 31 31 31 31 31 31 31 31 
31 30 30 30 30 30 30 30 30 30 30 30 30 31 31 32 2 2 0 2 0 0 0 0 0 0 30 31 31 31 31 31 31 31 31 31 31 31 31 31 30 31 31 31 31 31 31 31 31 31 
31 30 30 30 30 30 30 30 30 30 30 30 30 31 31 32 2 0 54 0 0 2 0 54 0 0 30 31 31 31 31 31 31 31 31 31 31 31 31 31 31 31 31 31 31 31 31 31 31 31 
31 30 30 30 30 30 30 30 30 30 30 30 30 31 31 32 0 51 52 52 52 52 53 0 2 0 30 31 31 31 31 31 31 31 31 31 31 31 31 31 31 31 31 31 31 31 31 31 31 31 
31 30 30 30 30 30 30 30 30 30 30 30 30 31 31 32 2 48 49 49 49 49 58 53 0 0 30 31 31 31 31 31 31 31 31 31 31 31 31 31 30 31 31 31 31 31 31 31 31 31 
31 30 30 30 30 30 30 30 30 30 30 30 30 31 31 32 0 45 46 46 46 46 46 47 0 0 30 30 30 30 30 30 30 30 30 30 30 30 30 30 30 30 30 30 30 30 30 30 30 30 
31 30 30 30 30 30 30 30 30 30 30 30 30 30 30 31 28 28 28 28 28 28 28 28 28 28 30 30 30 30 30 30 30 30 30 30 30 30 30 30 30 30 30 30 30 30 30 30 30 30 
31 30 30 30 30 30 30 30 30 30 30 30 30 30 30 30 30 30 30 30 30 30 30 30 30 30 30 30 30 30 30 30 30 30 30 30 30 30 30 30 30 30 30 30 30 30 30 30 30 30 
31 30 30 30 30 30 30 30 30 30 30 30 30 30 30 30 30 30 30 30 30 30 30 30 30 30 30 30 30 30 30 30 30 30 30 30 30 30 30 30 30 30 30 30 30 30 30 30 30 30 
31 30 30 30 30 30 30 30 30 30 30 30 30 30 30 30 30 30 30 30 30 30 30 30 30 30 30 30 30 30 30 30 30 30 30 30 30 30 30 30 30 30 30 30 30 30 30 30 30 30 
31 31 31 31 31 31 31 31 31 31 31 31 31 31 31 31 31 31 31 30 30 30 30 30 30 31 31 31 31 31 31 31 30 30 30 30 30 30 30 30 30 30 30 30 30 30 30 30 30 30 
