18 18 18 18 18 18 18 18 18 18 18 18 18 18 18 18 18 18 18 18 18 18 18 18 18 18 18 18 18 18 18 18 18 18 18 18 18 18 18 18 18 18 18 18 18 18 18 18 18 18 
18 18 18 18 18 18 18 18 18 18 18 18 18 18 18 18 18 18 18 18 18 18 18 18 18 18 18 18 18 18 18 18 18 18 18 18 18 18 18 18 18 18 18 18 18 18 18 18 18 18 
18 18 18 18 18 18 18 18 18 18 18 18 18 18 18 18 18 18 18 18 18 18 18 18 18 18 18 18 18 18 18 18 18 18 18 18 18 18 18 18 18 18 18 18 18 18 18 18 18 18 
18 18 18 18 18 18 18 18 18 18 18 18 18 18 18 18 18 18 18 18 18 18 18 18 18 18 18 18 18 18 18 18 18 18 18 18 18 18 18 18 18 18 18 18 18 18 18 18 18 18 
18 18 18 18 18 18 18 18 18 18 18 18 18 18 18 18 18 18 18 18 18 18 18 18 18 18 18 18 18 18 18 18 18 18 18 18 18 18 18 18 18 18 18 18 18 18 18 18 18 18 
18 18 18 18 18 18 18 18 18 18 18 18 18 18 18 18 18 18 18 18 18 18 18 18 18 18 18 18 18 18 18 18 18 18 18 18 18 18 18 18 18 18 18 18 18 18 18 18 18 18 
18 18 18 18 18 18 18 18 18 18 18 18 18 18 18 18 18 18 18 18 18 18 18 18 18 18 18 18 18 18 18 18 18 18 18 18 18 18 18 18 18 18 18 18 18 18 18 18 18 18 
18 18 18 18 18 18 18 18 18 18 18 18 18 18 18 18 18 18 18 18 18 18 18 18 18 18 18 18 18 18 18 18 18 28 26 26 26 26 26 26 26 29 18 18 18 18 18 18 18 18 
18 18 18 18 18 18 18 18 18 18 18 18 18 18 18 18 18 18 18 18 18 18 18 18 18 18 18 18 18 18 18 18 18 24 68 66 66 66 66 71 1 23 18 18 18 18 18 18 18 18 
18 18 18 18 18 18 18 18 18 18 18 18 18 18 18 18 18 18 18 18 18 18 18 18 18 18 18 18 18 18 18 18 18 24 64 72 73 72 72 67 52 23 18 18 18 18 18 18 18 18 
18 18 18 18 18 18 18 18 18 18 18 18 18 18 18 18 18 18 18 18 18 18 18 18 18 18 18 18 18 18 18 18 18 24 64 72 72 72 73 67 1 23 18 18 18 18 18 18 18 18 
18 18 18 18 18 18 18 18 18 18 18 18 28 26 26 26 26 26 26 26 26 26 26 26 26 26 26 26 26 26 26 26 26 27 69 65 65 65 65 70 1 23 18 18 18 18 18 18 18 18 
18 18 18 18 18 18 18 18 18 18 18 18 24 1 1 1 1 1 52 1 1 1 1 1 1 1 1 1 1 1 1 1 1 1 1 1 1 1 1 1 1 23 18 18 18 18 18 18 18 18 
18 18 18 18 18 18 18 18 18 18 18 18 24 52 1 1 1 46 46 46 46 46 1 2 1 1 1 1 1 1 1 1 52 1 1 52 1 1 1 1 1 23 18 18 18 18 18 18 18 18 
18 18 18 18 18 18 18 18 18 18 18 18 24 57 1 1 1 46 46 46 46 46 1 1 1 1 1 1 1 1 1 1 1 1 1 52 1 1 1 1 1 23 18 18 18 18 18 18 18 18 
18 18 18 18 18 18 18 18 18 18 18 18 24 56 1 1 1 46 46 46 46 46 46 46 46 46 46 46 46 1 1 1 1 1 1 1 1 1 1 1 1 23 18 18 18 18 18 18 18 18 
18 18 18 18 18 18 18 18 18 18 18 18 24 56 1 1 1 46 46 46 46 46 46 1 1 1 1 1 1 1 52 1 1 1 1 1 1 1 1 1 1 23 18 18 18 18 18 18 18 18 
18 18 18 18 18 18 18 18 18 18 18 18 24 56 52 1 1 46 46 46 46 46 46 46 46 46 46 1 1 1 1 1 55 58 58 58 58 58 58 58 54 23 18 18 18 18 18 18 18 18 
18 18 18 18 18 18 18 18 18 18 18 18 24 56 52 1 1 46 46 46 46 46 46 46 46 46 46 46 46 1 1 1 56 1 1 1 1 1 1 1 56 23 18 18 18 18 18 18 18 18 
18 18 18 18 18 18 18 18 18 18 18 18 24 56 52 1 68 66 71 1 68 66 66 66 66 66 66 66 66 66 66 71 56 1 1 1 1 1 1 1 56 23 18 18 18 18 18 18 18 18 
18 18 18 18 18 18 18 18 18 18 18 18 24 56 1 1 64 72 67 1 64 72 72 73 72 72 72 72 73 72 73 67 1 1 1 1 1 1 1 1 56 23 18 18 18 18 18 18 18 18 
18 18 18 18 18 18 18 18 18 18 18 18 24 56 1 1 64 73 67 1 69 65 65 65 65 65 65 65 65 65 65 70 1 1 1 1 1 1 1 1 56 23 18 18 18 18 18 18 18 18 
18 18 18 18 18 18 18 18 18 18 18 18 24 56 1 1 64 72 67 1 1 1 1 1 1 1 1 1 1 1 1 1 57 1 1 1 1 1 1 1 56 23 18 18 18 18 18 18 18 18 
18 18 18 18 18 18 18 18 18 18 18 18 24 1 1 1 64 72 67 1 1 1 1 1 1 1 1 1 1 1 1 1 56 1 1 1 1 1 1 1 56 23 18 18 18 18 18 18 18 18 
18 18 18 18 18 18 18 18 18 18 18 18 24 1 46 1 64 72 67 1 1 52 2 1 1 1 1 1 1 1 1 1 56 1 1 1 1 1 1 1 56 23 18 18 18 18 18 18 18 18 
18 18 18 18 18 18 18 18 18 18 18 18 24 46 46 1 64 73 67 1 1 1 1 1 1 1 1 1 1 1 1 1 56 1 1 1 1 1 1 1 56 23 18 18 18 18 18 18 18 18 
18 18 18 18 18 18 18 18 18 18 18 18 24 46 46 1 64 72 67 1 1 1 1 1 1 1 1 1 1 1 1 1 61 58 58 58 58 58 58 58 60 23 18 18 18 18 18 18 18 18 
18 18 18 18 18 18 18 18 18 18 18 18 24 46 46 1 64 72 67 1 46 46 46 46 46 46 1 1 1 1 1 1 1 1 1 1 1 1 1 1 1 23 18 18 18 18 18 18 18 18 
18 18 18 18 18 18 18 18 18 18 18 18 24 46 46 1 64 72 67 1 46 46 46 46 46 46 1 1 1 1 1 20 21 21 21 21 21 21 21 21 21 31 18 18 18 18 18 18 18 18 
18 18 18 18 18 18 18 18 18 18 18 18 24 46 46 1 64 72 67 46 46 52 46 46 46 46 1 1 1 1 1 23 18 18 18 18 18 18 18 18 18 18 18 18 18 18 18 18 18 18 
18 18 18 18 18 18 18 18 18 18 18 18 24 46 52 1 64 72 67 1 46 46 46 74 46 46 1 1 1 1 1 23 18 18 18 18 18 18 18 18 18 18 18 18 18 18 18 18 18 18 
18 18 18 18 18 18 18 18 18 18 18 18 24 52 1 1 64 72 67 1 1 47 47 47 47 47 47 47 1 1 1 23 18 18 18 18 18 18 18 18 18 18 18 18 18 18 18 18 18 18 
18 18 18 18 18 18 18 18 18 18 18 18 24 52 1 1 64 73 67 1 1 47 47 47 47 47 47 47 74 1 1 23 18 18 18 18 18 18 18 18 18 18 18 18 18 18 18 18 18 18 
18 18 18 18 18 18 18 18 18 18 18 18 24 46 1 1 69 65 70 1 1 1 1 1 1 1 1 1 1 1 1 23 18 18 18 18 18 18 18 18 18 18 18 18 18 18 18 18 18 18 
18 18 18 18 18 18 18 18 18 18 18 18 24 46 1 1 1 1 1 1 1 47 47 47 47 47 47 47 48 1 1 23 18 18 18 18 18 18 18 18 18 18 18 18 18 18 18 18 18 18 
18 18 18 18 18 18 18 18 18 18 18 18 24 46 1 1 1 52 1 1 1 47 47 47 47 47 47 47 1 52 1 23 18 18 18 18 18 18 18 18 18 18 18 18 18 18 18 18 18 18 
18 18 18 18 18 18 18 18 18 18 18 18 24 46 1 1 1 1 1 1 1 47 47 47 47 47 47 47 1 1 1 25 26 26 26 26 26 26 26 26 26 29 18 18 18 18 18 18 18 18 
18 18 18 18 18 18 18 18 18 18 18 18 24 46 46 1 1 1 1 1 1 47 47 47 47 47 47 47 48 1 1 1 1 1 46 46 46 53 53 46 1 23 18 18 18 18 18 18 18 18 
18 18 18 18 18 18 18 18 18 18 18 18 24 46 46 1 1 1 1 1 1 1 1 1 1 1 1 1 1 1 52 52 1 1 1 1 1 1 1 1 1 23 50 50 18 18 18 18 18 18 
18 18 18 18 18 18 18 18 18 18 18 18 30 21 21 21 21 21 21 21 21 21 21 21 21 21 21 21 21 21 21 21 21 21 21 21 21 21 21 21 21 31 18 18 18 18 18 18 18 18 
18 18 18 18 18 18 18 18 18 18 18 18 18 18 18 18 18 18 18 18 18 18 18 18 18 18 18 18 18 18 18 18 18 18 18 18 18 50 50 50 50 18 18 18 18 18 18 18 18 18 
18 18 18 18 18 18 18 18 18 18 18 18 18 18 18 18 18 18 18 18 18 18 18 18 18 18 18 18 18 18 18 18 18 18 18 18 18 18 18 18 18 18 18 18 18 18 18 18 18 18 
18 18 18 18 18 18 18 18 18 18 18 18 18 18 18 18 18 18 18 18 18 18 18 18 18 18 18 18 18 18 18 18 18 18 18 18 18 18 18 18 18 18 18 18 18 18 18 18 18 18 
18 18 18 18 18 18 18 18 18 18 18 18 18 18 18 18 18 18 18 18 18 18 18 18 18 18 18 18 18 18 18 18 18 18 18 18 18 18 18 18 18 18 18 18 18 18 18 18 18 18 
18 18 18 18 18 18 18 18 18 18 18 18 18 18 18 18 18 18 18 18 18 18 18 18 18 18 18 18 18 18 18 18 18 18 18 18 18 18 18 18 18 18 18 18 18 18 18 18 18 18 
18 18 18 18 18 18 18 18 18 18 18 18 18 18 18 18 18 18 18 18 18 18 18 18 18 18 18 18 18 18 18 18 18 18 18 18 18 18 18 18 18 18 18 18 18 18 18 18 18 18 
18 18 18 18 18 18 18 18 18 18 18 18 18 18 18 18 18 18 18 18 18 18 18 18 18 18 18 18 18 18 18 18 18 18 18 18 18 18 18 18 18 18 18 18 18 18 18 18 18 18 
18 18 18 18 18 18 18 18 18 18 18 18 18 18 18 18 18 18 18 18 18 18 18 18 18 18 18 18 18 18 18 18 18 18 18 18 18 18 18 18 18 18 18 18 18 18 18 18 18 18 
18 18 18 18 18 18 18 18 18 18 18 18 18 18 18 18 18 18 18 18 18 18 18 18 18 18 18 18 18 18 18 18 18 18 18 18 18 18 18 18 18 18 18 18 18 18 18 18 18 18 
18 18 18 18 18 18 18 18 18 18 18 18 18 18 18 18 18 18 18 18 18 18 18 18 18 18 18 18 18 18 18 18 18 18 18 18 18 18 18 18 18 18 18 18 18 18 18 18 18 18 
